11111
10E01
10C001
10PC1
11111